10
-.-.-.-.-.-.B.-.-.-
-.-.-.-.G.B.P.B.-.-
-.G.B.G.-.-.B.G.-.-
-.B.P.B.G.-.-.G.-.-
-.-.GB.-.B.A.-.-.-.-
-.G.-.B.P.B.B.G.-.-
S.-.-.G.B.GB.P.GB.-.-
W.S.-.-.-.-.B.-.-.-
S.G.-.-.G.B.P.GB.-.-
-.-.-.-.-.-.B.-.-.-