10
-.-.-.S.W.S.-.-.-.-
-.G.-.-.S.-.G.-.-.-
-.-.-.-.B.-.-.-.B.-
-.-.S.B.P.B.-.B.P.B
-.BS.W.S.B.-.G.S.B.-
B.P.BS.-.S.-.S.W.S.-
-.B.-.S.W.S.B.S.-.-
-.-.-.-.S.B.P.B.S.-
-.-.G.-.-.-.B.S.W.S
-.-.-.-.A.-.-.-.S.-
