10
-.-.B.P.B.S.-.-.-.-
-.-.G.B.S.W.S.B.G.-
B.-.-.-.-.S.B.P.B.-
P.B.-.-.-.G.-.B.S.-
B.S.-.-.G.A.G.S.W.S
S.W.S.-.-.G.-.-.S.-
-.S.-.-.-.B.-.-.S.-
S.W.GS.B.B.P.B.S.W.S
-.S.B.P.B.B.-.B.S.-
-.-.-.B.-.-.B.P.B.-
